MMMMMMMMMMM,
MMMMPPOMPPM,
MMMMPMPCOPM,
MMMMPPCMPPM,
MJCOPPPMMPM,
MPPPMMMPPPM,
MPPPMMMPPPM,
MMMMMMMMMMM,
